MIP_Afum_1	TTCTCAACGGGGGTGTTGCGTACACTCGTACGGTGGACCGGGTTGGA
MIP_Afum_2	TTCTCCATCGCTGGCTAGGACCCCCTAGGTCGATTACCTCCGATCGCCT
MIP_Afum_3	TTCTCAAGAAGTATGACGCTTTACCTAGTCTACGGGAATTGCTAACAGATCCAGC
MIP_Calb_1	TTGCTACTGACTCAAGTAAAGAACGGAGTGCAATTTAAAGTAATTGGCCCGTTA
MIP_Calb_2	TTGCTAGAACTCATAATCCAAAGGTATAAATCGGCACTAGTTTGATTTTTGTAGCGT
MIP_Calb_3	TTGCTGCATTTGTTGATATTGCTGCAAATTAGAGCAGTAAGTTAGATCATTTTGAATT
MIP_Calb_4	TTGCTGGCCTCATAAGCCGCAATCTTTGTGACCGTCGTACTTAAACCACTTGAAC
MIP_Calb_5	TTGCTCAGTGCATTTAGTATACTGAGTGAACTGGTACCTGTGACATTCAAGATAACTG
MIP_Calb_6	TTGCTACTGAGAAACCTTTGGTGGAGCATAACTATGACTGGTCGTTGCAGTAT
MIP_Calb_7	TTGCTTGCCGGTTGCCAACGCTTGTACCATTCTCTAGTACCAACTTACATCCT
MIP_Calb_8	TTGCTGATCTGCCATTATTGTACTGGCTTGATCTAGACTAATGAAAGTGTTTCCTGTA
MIP_Calb_9	TTGCTTCTTAATACAATAATTTAATACGGTAGTTAGTTGGTTTTCACTAATCAATTAACT
MIP_Calb_10	TTGCTATAAACCTATCGACCCTAGATCACGAGCACAGAAACGTGCTAAAAGCTATT
MIP_Calb_11	TTGCTCTTTTATACCAAACTCATGTTTCACGTCCTTCCGGCATATGTTTCC
MIP_Cdub_1	TTAGGACGGCTAGTGGTACACTAGGAGTAGCGCCAAACGCGTCTTCAC
MIP_Cdub_2	TTAGGATTAGTAATGGGCCTATAGGCACGTCGAAACTTATATTCCCCAACGACAA
MIP_Cdub_3	TTAGGATATGGGGAGGTCCGCTACTCGTGTAAGGGAATTCTGTATTTTGAAAAAC
MIP_Cgla_1	TCTTGTCAGAACCTGACTCCATACTAACATACTCGTCCGCACTCACACG
MIP_Cgla_2	TCTTGGTGATATCTACCTGGTACACGTAATCTAACGAACATAGCATGTTGAAC
MIP_Cgla_3	TCTTGCTTTAATGGTCAGAGCGCTAGTGCGTACATCGGTTCATACCCCTATTG
MIP_Ckos_1	TCCGTTAGCCGGGTTTAAGCGTCAACTAAGCCCGTAATTTGCGATACACGAGAA
MIP_Ckos_2	TCCGTCGTTACCGGCATTCCGACGTAAGGGGCGATTTCCGCCAGAT
MIP_Cpar_1	TCGACTCTACAGTCTCTCGTGTCTACCCCGCGTGAGTGGAGACGGTGCG
MIP_Cpar_2	TCGACGATGCCCACTTACGTGACTAGACTCCCCATACCGACGCGTCAG
MIP_Cpar_3	TCGACCAACCAAACCATGCCTATCCAACTAACGGACGATGAGCCTTTCACG
MIP_Ctro_1	TCACACACATAAAGCACCCTACCGGTTAACGTGGGAGGAGAAGCAAGAATTAGA
MIP_Ctro_2	TCACAGGTAATGACAATCTTGTATGCATATGGGACGCTAGATCTACGTCTAATGCTC
MIP_Ctro_3	TCACAAATGATAAGTTTGTGGCCTCCGATAGGGTTGGTCATTTCTGGAATTTTTTAC
MIP_Ecol_1	TGTCCGGTGATGCGCATTATGTGTCGTCGCGGCTTCGAAATGGACTTTGCTG
MIP_Ecol_2	TGTCCAACGTCGTTACTATCCTTACGGTTCGGCGTTGACCCACGTCATCG
MIP_Ecol_3	TGTCCAAGCCAGCCAGTTCCAGGATTTTCGCTTCCCACTCTGCGTCG
MIP_Ecol_4	TGTCCGAGGAAGGGAGTAAAGTTAATACCTTTGCTCATTGACGTTACCCGCA
MIP_Efae_1	TGCAGGATCGCTTTGTTGGCTTAATCGGCTTGACAGACGTTGTAGATAAAATGTTTGATT
MIP_Efae_2	TGCAGCTGATTTAATCACGCCAGATTCGCCGACACAACGTGTAGGTGGCAA
MIP_Efae_3	TGCAGTTAGAAGTTGTTGAGATCGGAGCAACGCGTAGTGTTGGTTCTGTTCCC
MIP_Efae_4	TGCAGGGACTTCTTACGGACTATTAGGAATCCCAGGAGACTTC
MIP_Efae_5	TGCAGCTAAAGTCATTCGGCGGGCGCTAGACATTTGGAAACCAATCGG
MIP_Efae_6	TGCAGTATGCCATGCGGCATAAACTGTTATGCGGTATTAGCACCTGTTTCCAAGT
MIP_Efae_7	TGCAGGAATTTACAGATCCGGAACAAATTTTTCACGAGATTCGGATGAATTGG
MIP_Efae_8	TGCAGTGGTTCCCATTTTCTTCGTAATACTCCACGTAATCCCAACTGGCAAGA
MIP_Efae_9	TGCAGGAATTTACCGTTTAGTGTGCATACGAGAGAGGCATTAGAAGATACCTATCGA
MIP_Efae_10	TGCAGAAACTAATGGCACTCGTAGTACCGACCGCATTTTTCAACTCGGTAGGTTG
MIP_Efae_11	TGCAGTACCGACCGCATTTTTCAACTCGGTAGGTTGGTTGTAATTTGAGAAACTCG
MIP_Efae_12	TGCAGCTATCAGTTACCGGATTTGTAACGTGTCGGACAGAATACTTTTGTGGAGAAGG
MIP_Efam_1	TGGTACTTGTAATTTCCCTTTACCGATAATCGTTTGCCGATCCACTTGTG
MIP_Efam_2	TGGTATGCTTCCGCCGTTTATACGTGTTTAGAGCGTGAGACAAAAGTGTTCTTTAC
MIP_Efam_3	TGGTACAAAACGAACGGGGAATGGCGATACTTTGACAGCACAAGAGTGGCT
MIP_Efam_4	TGGTAAATACTGTAGACATTTTCGCTTGCTACACCGACTTCTTTTGGTTCCATGT
MIP_Efam_5	TGGTAATGAGATCAATGCGTAACTGACGCTAAGTGCAACATGCCCCAGCGAGG
MIP_Efam_6	TGGTATAAATGAGATCAATGCGTAACTGACGCTAAGTGCAACATGCCCCAG
MIP_Efam_7	TGGTAAGATGCGGTTGTTTTATACGGAAATTCGCCAGAAATCGGGAAAGTAGAAGA
MIP_Efam_8	TGGTACTTTTTGGACCGCTTCTGGCGAAATCTCGTCCCCAATCTTTTTTTTGA
MIP_Hinf_1	CTTCGACACCTTTCGCTTCACTCACTCTCAGAGTGGTGGGTCTGAGTGG
MIP_Hinf_2	CTTCGGCTTAGTACCACAATATGGTTTTTAGATACGGGATTATCACCCTCTTTGA
MIP_Hinf_3	CTTCGCTTTCGTTTCACTCACTCTCAGAGTGGTGGGTCTGAGTGGACTTGAACC
MIP_Koxy_1	CTCGAGGCAGAAGTGCATAGATGCACGCTTCATTACGGCGCATGATTATG
MIP_Kpne_1	CTAACGGGAGAAGGCACGCTGGTGTGTAGGTGAAGTCCCTGCGGATG
MIP_Kpne_2	CTAACTCAGAGTCAACCCGTTTTTCAGGATTTTTCTCTGCAACCGAACCG
MIP_Kpne_3	CTAACTCCGTGCAAAACACGGCCCTCAGCCCGCATCCATGCGGGCTG
MIP_Kpne_4	CTAACCCTGAACCATAACCCGAACAATCCGGCCTGGGCTGACCGTGAC
MIP_Kpne_5	CTAACCGCAGGGACTTCACCTACACACCAGCGTGCCTTCTCCCGAAG
MIP_Kpne_6	CTAACACTTTACCCGGCCGAGTATCGTTATCAAACCTAACGCCAATGC
MIP_Kpne_7	CTAACGCAGGGACTTCACCTACACACCAGCGTGCCTTCTCCCGAAGTTAC
MIP_Kpne_8	CTAACGGCTGGCCACCTGGATACCTATATCCCGGAACCAGAGCGT
MIP_mecA_1	CCTATGCTATTATCGTCAACGATTGTGACACGATAGCCATCTTCATGTTGGAG
MIP_mecA_2	CCTATAGCAACCATCGTTACGGATTGCTTCACTGTTTTGTTATTCATCTATATCGTAT
MIP_mecA_3	CCTATTGTATTGGCCAATTCCACATTGTTTCGGTCTAAAATTTTACCACGTTCTGATTT
MIP_mecA_4	CGCTTGCCAAAAAATTTGAGCAAGGTATGCAAGATTTGGGAATCGGTGAAAA
MIP_mecA_5	CGCTTAATCGGTGAAAATATCCCGAGTGATTATCCCTTTTATAAAGCACAAATCTCA
MIP_mecA_6	CGCTTGGATAATCACTCGGGATATTTTCACCGATTCCCAAATCTTGCATACCTT
MIP_Pmirab_1	CATTCGGTCGGGGTTGTCTGGCTCTTGCGAGGTTAACCGCAACATATAGTGTTTA
MIP_Nmen_1	CAGCAGCCGTTGCTTTTGTCTTGGCGAAGGTAGCGGTAAATGGTGCTGTGGTG
MIP_Nmen_2	CAGCAGTTCAGTTGCTACGGTTACTGTCAGGTTTCGGTTATGTTGGAATTTCG
MIP_Nmen_3	CAGCATCCACCACAACGGTATAGACCCGTCCGTTGCGTTTCAGAATGCC
MIP_Paer_1	CAAGTCGTGTGTCTCCCATGCTCGGCACTTCTGGGTATTCGGAGTTTGCA
MIP_Paer_2	CAAGTTCAAGCATTTACTCTTCGTCGTCGCCGGGAGTGGTGCGCATTATAGG
MIP_Paer_3	CAAGTGTGCGGCACGTGACGCTGGCCTACACCCTCTTCGATATCACTGC
MIP_Paer_4	CAAGTCAGGAACAGATCTTCGTCCATGCCCAGCGCGACTGGGACGAGAACAT
MIP_Paer_5	CAAGTTGGCCTTCCTGGTAGGTGTTGCCGACCGAATCCTCGGTGAAGGC
MIP_Paer_6	CAAGTGGTGCCGGTGATGGACATATAGGCGGGGGTTGCCATGGATAC
MIP_Paer_7	CAAGTAACCAGGGAATCACGGCACACATGAGCAAGACGATCACATGGACG
MIP_Paer_8	CAAGTCGATGAGGAACGACAGGGCGAGCATCTTCAGCGAGGGGTGTTT
MIP_Paer_9	CAAGTTGGCATCGGTCAATGCCGCTAGTCGGCCTTCCTTCTGCCATTGG
MIP_Saga_1	GTTGTGTCACGGAAACAAAGGTGTCGTCTCACGTATTGTTCCTGTTGAAGATATGC
MIP_Saga_2	GTTGTGTAAGAGTTGCACTTGACGGATATCTAGGCGATCAAATAAACAAGCAAA
MIP_Saga_3	GTTGTCCCGATCATATTGGTCCTATCGAGCACCCTACATTCGAAGATTATTTTTTC
MIP_Saur_1	GTGTGCATTAGGGACAGTACCTAAGTTAGACGATTCTCGTGTCTTACTTGCACAAG
MIP_Saur_2	GTGTGTTTTAAAAGATTAGCGTTATACGGTGAGTACAACATGATCTGTTAATATAACAAGCC
MIP_Saur_3	GTGTGCTTAGCGTCGATGGTAGTCGAACTTACGTTCCGCTAGAGTAGAACGTT
MIP_Saur_4	GTGTGATAAATCAATGTTCTATGCTCTACGAAGTTATATTGGCAGTAGTTGACTGAAC
MIP_Saur_5	GTGTGGGTAATAATCCTGTAGTCGAAAATGTTGTCTCTCTTGAGTGGATCCTGAG
MIP_Saur_6	GTGTGAGGATAGGCGAAGCGTGCGATTGGATTGCACGTCTAAGCAGTAAGG
MIP_Sepi_1	GCCTAGTACGGTTTAACATTAATTCTGAATCGTGAGGGTTAACTCGTAAGTCAGCACG
MIP_Sepi_2	GCCTAATCGGTCGTGTAGCACAAGTGCATATTGACGATAAAGTAATTATGGACAACG
MIP_Shae_1	GCAAGACTTAAGTGAGTGGGTTATCTATCTAAGATCGACTTTAGAGAACTATTTTAGAAC
MIP_Shae_2	GCAAGGTTCGATGGCTAATCCGTAAGTGACATCGGCATTGCCTACTGCTTTA
MIP_Shae_3	GCAAGTACAAGTATCCTCGTCTCTTCGATATTGTACACAAGGCCATCGATCAGAC
MIP_Slug_1	GGTAAGCTTGAGTATTGCACTTTGACTAATACGTCACCTTCTGGTAGGTCGTCG
MIP_Slug_2	GGTAATGTCAGTGTGATCAGCGTTAGGCTGCTCATTCGTTTCCACTGTCGG
MIP_Slug_3	GGTAAACGTATTACCACTGCTATACATAGCGTACAAAATACGGCGTTGTACTGG
MIP_Smut_1	GGATCACATGCTTTAAAACGAACCCTAGCAGAGGCCGCTGCTATTAGTCAGGTGA
MIP_Smut_2	GGATCGAAGTCATGCGGACACTTAATACGCTGGATGTTACCGCCATAGAAGAAA
MIP_Spne_1	GACCTGTGGAAAGAGATTCGTAAACGTGGATTTAAGAATAAAGCCTTTCGAACTTT
MIP_Spne_2	GACCTGCTCTTAGTACTTGGTTTGTTTACCGTTATGCGGATAAGATTCAAAAAGAT
MIP_Spne_3	GACCTAGGGTTATACTCCTGGTCACAAATCCTACGTCAGTCAAGAGAAGATTGC
MIP_Spne_4	GACCTGTCTTTGTCACTTGCTTCTCTCAAGCGACAACTATATTAGTATATCACAGCCA
MIP_Spne_5	GACCTAACTTTTAAGTTAATTCGGGCATCCAACTCTTGTTCTGGTTGGAAGTACTTTTC
MIP_Spyo_1	ATGGCTCGGGGCATTACTGACAACAGGTAGCGTTATTGTTACCTGGCTTGGAG
MIP_Spyo_2	ATGGCCTAGTGTATAGCCATATACGTTAGCATTGACTGCTGTTCCATTTGAAAAG
MIP_Spyo_3	ATGGCGCTTTTTTCAGAGATATAGGAGGTTTGACTAGCGATGCCAACATTTCTA
MIP_Ssal_1	ACTGAGAGTGCTAGGTGTTGGATCCTTTCCGGGATTCAGTGCCGCAGCTA
MIP_Ssal_2	ACTGACTATGACCTCGGGACGCCAGTTTCGAGTGAGGCGTTGTTGGG
MIP_Ssal_3	ACTGACACTGCGGCTGACCATAAGTCAGCGCCCCTTCTCCCGAAGTTACG
MIP_Ssang_1	ACGTTGTCCCAAGAACCGTTCCCTTACTAGGCCTTTAAGCCTATCCAGGTCTTC
MIP_Ssang_2	ACGTTGTTCCATCTGATCAACGATGTCGTATGGGCTAGTGTAAGTCTGATTGTCAATC
MIP_Ssapr_1	AGCCATCTAGGACTGTCGGCTATCTTATCCGGACTCGTCATCTTGCCCGGA
MIP_Ssapr_2	AGCCATCAAATATCGCATTATAAGTTTGACGTGTCCGTAATAAATCCGAAATATAAATAT
MIP_Staph_1	AACTGCCTTCCTCTGGAAACCTTAGTCAATCGGTGGACGGGATTCTCACC
MIP_Staph_2	AACTGGAATTTCACGTGCTCCGTCGTACTCAGGATCCACTCAAGAGAGACAACATT
MIP_Staph_3	AACTGTCTCCGCTACCCTCAGTTCATCCGCTCACTTTTCAACGTAAGTCGGTT
MIP_Strep_1	TGCACCGTGTGCCTACAACAAGTTCGAGCCCGTTAATGGGTGAGAGCGTG
MIP_Strep_2	TGCACTGGGTTAGTCGGGACCTAAGGAGAGACCGAAAGGTGTATCCGATG
MIP_Strep_3	TGCACATTTGTAATCAGAGGGTCGCGTGTTCAAGTCATGTAGCCGGCATT
MIP_Strep_4	TGCACCAGCCGCGGTAATACGTAGGTCCCGAGCGTTGTCCGGATTTATTG
MIP_Strep_5	TGCACCCGTAGTGTAGCGGTTATCACGTCGCCCTGTCACGGCGAAGATC
MIP_Strep_6	TGCACGTCCACCGTAAGACTAAGGTTTCCAGGGGAAGGCTCGTCCGCC
MIP_Strep_7	TGCACAGTCAGACTGCGAGTGCTAAGATCCGTAGTCGAAAGGGAAACAGC
MIP_vanA_1	GTGCTCAGAGGAGCGAGGACGGATACAGGAAACGGCAAAAAAAATATATAAAGC
MIP_vanA_2	GTGCTTTTCCGGCTCGACTTCCTGATGAATACGAAAGATTCCGTACTGCAG
MIP_vanA_3	GTGCTGGAAACAGTGCCGCGTTAGTTGTTGGCGAGGTGGACCAAATCAGG
MIP_EC1		TGTCCAGTCGAGCATCTCTTCAGCGTAAGGGTAATGCGAGGTACG
MIP_Koxy2	CTCGACCTGCTGCAGCGCCTGGGTATTCAGCGTGGTGCCGTCAC
MIP_Kpneu2	CTAACATTCACAAGAAGCCGTTGATGTGAAACCTGGGTCAAAGGTA
MIP_PA3		CAAGTCGACCTGTCGACCACCGGCAGTCCGGCGATTTCCAGCCAGTAC
MIP_PA5		CAAGTGAACACCTTGATGTTCGAAGGCTTCTCGTGGCCGATCGGCACC
MIP_PA6		CAAGTCACTTTCTCCCTCAGGACGTATGCGGTATTAGCGCC
MIP_Pmira1	CATTCGGGGCAACCACCGCTAAGTTGGTAGTTTGAGAATGCGCA
MIP_Pmira2	CATTCACGACGACGTAATGCTAATAAGTAGCTACCTTTAGCAAA
MIP_SA2		GTGTGACCTGAAACAAAGCATCCTAAAAAAGGTGTAGAGAAATATGG
MIP_mecA1	CCTATTGAATTATTAGCACTTGTAAGCACACCTTCATATGACGTCTAT
MIP_KPC		GCATTTACAGTGATAACGCCGCCGCCAATTTGTTGCTGAAGGAGTTGG
MIP_NDM2	ATCGCCACCGAATGTCTGGCAGCACACTTCCTATCTCGACATGCCGG
MIP_Oxa_48	GTAGAAAGGATTTACCAATAATCTTAAACGGGCGAACCAAGCATTTTTA
MIP_VIM		TCCATGGTGATGAGTTGCTTTTGATTGATACAGCGTGGGGTGCG
